4 4 4 4 4 4 4 4 4 4
4 4 4 4 4 4 4 4 4 4
4 4 4 4 4 4 4 4 4 4 
4 1 1 1 1 1 1 1 1 4
4 1 3 0 0 0 0 0 1 4
4 1 0 3 2 2 2 0 1 4
4 1 3 0 0 0 0 0 1 4
4 1 1 1 1 1 0 0 1 4
4 4 4 4 4 1 1 1 1 4
4 4 4 4 4 4 4 4 4 4
7 10 3 4 12 5 3 6 2